5
30 30
BBBBBBBBBBBBBBBBBBBBBBBBBBBBBB
B~~~~~~~~~~~~~~~~~~~~~~~~~~~~B
B~~~~~~~~~~~~~~~~~~~~~~~~~~~~B
B~~~~~~~~~~~~~~~~~~~~~~~~~~~~B
B~~~~~~~~~~~~~~~~~~~~~~~~~~~~B
B~~~~~~~~~~~~~~~~~~~~~~~~~~~~B
B~~~~~~~~~~~~~~~~~~~~~~~~~~~~B
B~~~~~~~~~~~~~~~~~~~~~~~~~~~~B
B~~~~~~~~~~~~~~~~~~~~~~~~~~~~B
B~~~~~~~~~~~~~~~~~~~~~~~~~~~~B
B~~~~~~~~~~~~~~~~~~~~~~~~~~~~B
B~~~~~~~~~~~~~~~~~~~~~~~~~~~~B
B~~~~~~~~~~~~~~~~~~~~~~~~~~~~B
B~~~~~~~~~~~~~~~~~~~~~~~~~~~~B
B~~~~~~~~~~~~~~~~~~~~~~~~~~~~B
B~~~~~~~~~~~~~~~~~~~~~~~~~~~~B
B~~~~~~~~~~~~~~~~~~~~~~~~~~~~B
B~~~~~~~~~~~~~~~~~~~~~~~~~~~~B
B~~~~~~~~~~~~~~~~~~~~~~~~~~~~B
B~~~~~~~~~~~~~~~~~~~~~~~~~~~~B
B~~~~~~~~~~~~~~~~~~~~~~~~~~~~B
B~~~~~~~~~~~~~~~~~~~~~~~~~~~~B
B~~~~~~~~~~~~~~~~~~~~~~~~~~~~B
B~~~~~~~~~~~~~~~~~~~~~~~~~~~~B
B~~~~~~~~~~~~~~~~~~~~~~~~~~~~B
B~~~~~~~~~~~~~~~~~~~~~~~~~~~~B
B~~~~~~~~~~~~~~~~~~~~~~~~~~~~B
B~~~~~~~~~~~~~~~~~~~~~~~~~~~~B
B~~~~~~~~~~~~~~~~~~~~~~~~~~~~B
BBBBBBBBBBBBBBBBBBBBBBBBBBBBBB
255 255 255 255 255 255 255 255 255 255 255 255 255 255 255 255 255 255 255 255 255 255 255 255 255 255 255 255 255 255
255 0 0 0 0 0 0 0 0 0 0 0 0 0 0 0 0 0 0 0 0 0 0 0 0 0 0 0 0 255
255 0 0 0 0 0 0 0 0 0 0 0 0 0 0 0 0 0 0 0 0 0 0 0 0 0 0 0 0 255
255 0 0 0 0 0 0 0 0 0 0 0 0 0 0 0 0 0 0 0 0 0 0 0 0 0 0 0 0 255
255 0 0 0 0 0 0 0 0 0 0 0 0 0 0 0 0 0 0 0 0 0 0 0 0 0 0 0 0 255
255 0 0 0 0 0 0 0 0 0 0 0 0 0 0 0 0 0 0 0 0 0 0 0 0 0 0 0 0 255
255 0 0 0 0 0 0 0 0 0 0 0 0 0 0 0 0 0 0 0 0 0 0 0 0 0 0 0 0 255
255 0 0 0 0 0 0 0 0 0 0 0 0 0 0 0 0 0 0 0 0 0 0 0 0 0 0 0 0 255
255 0 0 0 0 0 0 0 0 0 0 0 0 0 0 0 0 0 0 0 0 0 0 0 0 0 0 0 0 255
255 0 0 0 0 0 0 0 0 0 0 0 0 0 0 0 0 0 0 0 0 0 0 0 0 0 0 0 0 255
255 0 0 0 0 0 0 0 0 0 0 0 0 0 0 0 0 0 0 0 0 0 0 0 0 0 0 0 0 255
255 0 0 0 0 0 0 0 0 0 0 0 0 0 0 0 0 0 0 0 0 0 0 0 0 0 0 0 0 255
255 0 0 0 0 0 0 0 0 0 0 0 0 0 0 0 0 0 0 0 0 0 0 0 0 0 0 0 0 255
255 0 0 0 0 0 0 0 0 0 0 0 0 0 0 0 0 0 0 0 0 0 0 0 0 0 0 0 0 255
255 0 0 0 0 0 0 0 0 0 0 0 0 0 0 0 0 0 0 0 0 0 0 0 0 0 0 0 0 255
255 0 0 0 0 0 0 0 0 0 0 0 0 0 0 0 0 0 0 0 0 0 0 0 0 0 0 0 0 255
255 0 0 0 0 0 0 0 0 0 0 0 0 0 0 0 0 0 0 0 0 0 0 0 0 0 0 0 0 255
255 0 0 0 0 0 0 0 0 0 0 0 0 0 0 0 0 0 0 0 0 0 0 0 0 0 0 0 0 255
255 0 0 0 0 0 0 0 0 0 0 0 0 0 0 0 0 0 0 0 0 0 0 0 0 0 0 0 0 255
255 0 0 0 0 0 0 0 0 0 0 0 0 0 0 0 0 0 0 0 0 0 0 0 0 0 0 0 0 255
255 0 0 0 0 0 0 0 0 0 0 0 0 0 0 0 0 0 0 0 0 0 0 0 0 0 0 0 0 255
255 0 0 0 0 0 0 0 0 0 0 0 0 0 0 0 0 0 0 0 0 0 0 0 0 0 0 0 0 255
255 0 0 0 0 0 0 0 0 0 0 0 0 0 0 0 0 0 0 0 0 0 0 0 0 0 0 0 0 255
255 0 0 0 0 0 0 0 0 0 0 0 0 0 0 0 0 0 0 0 0 0 0 0 0 0 0 0 0 255
255 0 0 0 0 0 0 0 0 0 0 0 0 0 0 0 0 0 0 0 0 0 0 0 0 0 0 0 0 255
255 0 0 0 0 0 0 0 0 0 0 0 0 0 0 0 0 0 0 0 0 0 0 0 0 0 0 0 0 255
255 0 0 0 0 0 0 0 0 0 0 0 0 0 0 0 0 0 0 0 0 0 0 0 0 0 0 0 0 255
255 0 0 0 0 0 0 0 0 0 0 0 0 0 0 0 0 0 0 0 0 0 0 0 0 0 0 0 0 255
255 0 0 0 0 0 0 0 0 0 0 0 0 0 0 0 0 0 0 0 0 0 0 0 0 0 0 0 0 255
255 255 255 255 255 255 255 255 255 255 255 255 255 255 255 255 255 255 255 255 255 255 255 255 255 255 255 255 255 255
30 30
BBBBBBBBBBBBBBBBBBBBBBBBBBBBBB
B~~~~~~~~~~~~~~~~~~~~~~~~~~~~B
B~~~~~~~~~~~~~~~~~~~~~~~~~~~~B
B~~~~~~~~~~~~~~~~~~~~~~~~~~~~B
B~~~~~~~~~~~~~~~~~~~~~~~~~~~~B
B~~~~~~~~~~~~~~~~~~~~~~~~~~~~B
B~~~~~~~~~~~~~~~~~~~~~~~~~~~~B
B~~~~~~~~~~~~~B~~~~~~~~~~~~~~B
B~~~~~~~~~~~~~B~~~~~~~~~~~~~~B
B~~~~~~~~~~~~~B~~~~~~~~~~~~~~B
B~~~~~~~~~~~~~B~~~~~~~~~~~~~~B
B~~~~~~~~~~~~~B~~~~~~~~~~~~~~B
B~~~~~~~~~~~~~B~~~~~~~~~~~~~~B
B~~~~~~~~~~~~~B~~~~~~~~~~~~~~B
B~~~~~~BBBBBBBBBBBBBBB~~~~~~~B
B~~~~~~~~~~~~~B~~~~~~~~~~~~~~B
B~~~~~~~~~~~~~B~~~~~~~~~~~~~~B
B~~~~~~~~~~~~~B~~~~~~~~~~~~~~B
B~~~~~~~~~~~~~B~~~~~~~~~~~~~~B
B~~~~~~~~~~~~~B~~~~~~~~~~~~~~B
B~~~~~~~~~~~~~B~~~~~~~~~~~~~~B
B~~~~~~~~~~~~~B~~~~~~~~~~~~~~B
B~~~~~~~~~~~~~~~~~~~~~~~~~~~~B
B~~~~~~~~~~~~~~~~~~~~~~~~~~~~B
B~~~~~~~~~~~~~~~~~~~~~~~~~~~~B
B~~~~~~~~~~~~~~~~~~~~~~~~~~~~B
B~~~~~~~~~~~~~~~~~~~~~~~~~~~~B
B~~~~~~~~~~~~~~~~~~~~~~~~~~~~B
B~~~~~~~~~~~~~~~~~~~~~~~~~~~~B
BBBBBBBBBBBBBBBBBBBBBBBBBBBBBB
255 255 255 255 255 255 255 255 255 255 255 255 255 255 255 255 255 255 255 255 255 255 255 255 255 255 255 255 255 255
255 0 0 0 0 0 0 0 0 0 0 0 0 0 0 0 0 0 0 0 0 0 0 0 0 0 0 0 0 255
255 0 0 0 0 0 0 0 0 0 0 0 0 0 0 0 0 0 0 0 0 0 0 0 0 0 0 0 0 255
255 0 0 0 0 0 0 0 0 0 0 0 0 0 0 0 0 0 0 0 0 0 0 0 0 0 0 0 0 255
255 0 0 0 0 0 0 0 0 0 0 0 0 0 0 0 0 0 0 0 0 0 0 0 0 0 0 0 0 255
255 0 0 0 0 0 0 0 0 0 0 0 0 0 0 0 0 0 0 0 0 0 0 0 0 0 0 0 0 255
255 0 0 0 0 0 0 0 0 0 0 0 0 0 0 0 0 0 0 0 0 0 0 0 0 0 0 0 0 255
255 0 0 0 0 0 0 0 0 0 0 0 0 0 255 0 0 0 0 0 0 0 0 0 0 0 0 0 0 255
255 0 0 0 0 0 0 0 0 0 0 0 0 0 255 0 0 0 0 0 0 0 0 0 0 0 0 0 0 255
255 0 0 0 0 0 0 0 0 0 0 0 0 0 255 0 0 0 0 0 0 0 0 0 0 0 0 0 0 255
255 0 0 0 0 0 0 0 0 0 0 0 0 0 255 0 0 0 0 0 0 0 0 0 0 0 0 0 0 255
255 0 0 0 0 0 0 0 0 0 0 0 0 0 255 0 0 0 0 0 0 0 0 0 0 0 0 0 0 255
255 0 0 0 0 0 0 0 0 0 0 0 0 0 255 0 0 0 0 0 0 0 0 0 0 0 0 0 0 255
255 0 0 0 0 0 0 0 0 0 0 0 0 0 255 0 0 0 0 0 0 0 0 0 0 0 0 0 0 255
255 0 0 0 0 0 0 255 255 255 255 255 255 255 255 255 255 255 255 255 255 255 0 0 0 0 0 0 0 255
255 0 0 0 0 0 0 0 0 0 0 0 0 0 255 0 0 0 0 0 0 0 0 0 0 0 0 0 0 255
255 0 0 0 0 0 0 0 0 0 0 0 0 0 255 0 0 0 0 0 0 0 0 0 0 0 0 0 0 255
255 0 0 0 0 0 0 0 0 0 0 0 0 0 255 0 0 0 0 0 0 0 0 0 0 0 0 0 0 255
255 0 0 0 0 0 0 0 0 0 0 0 0 0 255 0 0 0 0 0 0 0 0 0 0 0 0 0 0 255
255 0 0 0 0 0 0 0 0 0 0 0 0 0 255 0 0 0 0 0 0 0 0 0 0 0 0 0 0 255
255 0 0 0 0 0 0 0 0 0 0 0 0 0 255 0 0 0 0 0 0 0 0 0 0 0 0 0 0 255
255 0 0 0 0 0 0 0 0 0 0 0 0 0 255 0 0 0 0 0 0 0 0 0 0 0 0 0 0 255
255 0 0 0 0 0 0 0 0 0 0 0 0 0 0 0 0 0 0 0 0 0 0 0 0 0 0 0 0 255
255 0 0 0 0 0 0 0 0 0 0 0 0 0 0 0 0 0 0 0 0 0 0 0 0 0 0 0 0 255
255 0 0 0 0 0 0 0 0 0 0 0 0 0 0 0 0 0 0 0 0 0 0 0 0 0 0 0 0 255
255 0 0 0 0 0 0 0 0 0 0 0 0 0 0 0 0 0 0 0 0 0 0 0 0 0 0 0 0 255
255 0 0 0 0 0 0 0 0 0 0 0 0 0 0 0 0 0 0 0 0 0 0 0 0 0 0 0 0 255
255 0 0 0 0 0 0 0 0 0 0 0 0 0 0 0 0 0 0 0 0 0 0 0 0 0 0 0 0 255
255 0 0 0 0 0 0 0 0 0 0 0 0 0 0 0 0 0 0 0 0 0 0 0 0 0 0 0 0 255
255 255 255 255 255 255 255 255 255 255 255 255 255 255 255 255 255 255 255 255 255 255 255 255 255 255 255 255 255 255
30 30
BBBBBBBBBBBBBBBBBBBBBBBBBBBBBB
B~~~~~~~~~~~~~~~~~~~~~~~~~~~~B
B~~~~~~~~~~~~~~~~~~~~~~~~~~~~B
B~~~~~~~~~~~~~~~~~~~~~~~~~~~~B
B~~~~~~~~~~~~~~~~~~~~~~~~~~~~B
B~~~~~~~~~~~~~~~~~~~~~~~~~~~~B
B~~~~~~~~~~~~~~~~~~~~~~~~~~~~B
B~~~~~~~~~~~~~~~~~~~~~~~~~~~~B
B~~~~~~~~~~~~~~~~~~~~~~~~~~~~B
B~~~~~~~~~~~~~~~~~~~~~~~~~~~~B
B~~~~BBBBBBBBBBBBBBBBBBBB~~~~B
B~~~~~~~~~~~~~~~~~~~~~~~~~~~~B
B~~~~~~~~~~~~~~~~~~~~~~~~~~~~B
B~~~~~~~~~~~~~~~~~~~~~~~~~~~~B
B~~~~~~~~~~~~~~~~~~~~~~~~~~~~B
B~~~~~~~~~~~~~~~~~~~~~~~~~~~~B
B~~~~~~~~~~~~~~~~~~~~~~~~~~~~B
B~~~~~~~~~~~~~~~~~~~~~~~~~~~~B
B~~~~~~~~~~~~~~~~~~~~~~~~~~~~B
B~~~~BBBBBBBBBBBBBBBBBBBB~~~~B
B~~~~~~~~~~~~~~~~~~~~~~~~~~~~B
B~~~~~~~~~~~~~~~~~~~~~~~~~~~~B
B~~~~~~~~~~~~~~~~~~~~~~~~~~~~B
B~~~~~~~~~~~~~~~~~~~~~~~~~~~~B
B~~~~~~~~~~~~~~~~~~~~~~~~~~~~B
B~~~~~~~~~~~~~~~~~~~~~~~~~~~~B
B~~~~~~~~~~~~~~~~~~~~~~~~~~~~B
B~~~~~~~~~~~~~~~~~~~~~~~~~~~~B
B~~~~~~~~~~~~~~~~~~~~~~~~~~~~B
BBBBBBBBBBBBBBBBBBBBBBBBBBBBBB
255 255 255 255 255 255 255 255 255 255 255 255 255 255 255 255 255 255 255 255 255 255 255 255 255 255 255 255 255 255
255 0 0 0 0 0 0 0 0 0 0 0 0 0 0 0 0 0 0 0 0 0 0 0 0 0 0 0 0 255
255 0 0 0 0 0 0 0 0 0 0 0 0 0 0 0 0 0 0 0 0 0 0 0 0 0 0 0 0 255
255 0 0 0 0 0 0 0 0 0 0 0 0 0 0 0 0 0 0 0 0 0 0 0 0 0 0 0 0 255
255 0 0 0 0 0 0 0 0 0 0 0 0 0 0 0 0 0 0 0 0 0 0 0 0 0 0 0 0 255
255 0 0 0 0 0 0 0 0 0 0 0 0 0 0 0 0 0 0 0 0 0 0 0 0 0 0 0 0 255
255 0 0 0 0 0 0 0 0 0 0 0 0 0 0 0 0 0 0 0 0 0 0 0 0 0 0 0 0 255
255 0 0 0 0 0 0 0 0 0 0 0 0 0 0 0 0 0 0 0 0 0 0 0 0 0 0 0 0 255
255 0 0 0 0 0 0 0 0 0 0 0 0 0 0 0 0 0 0 0 0 0 0 0 0 0 0 0 0 255
255 0 0 0 0 0 0 0 0 0 0 0 0 0 0 0 0 0 0 0 0 0 0 0 0 0 0 0 0 255
255 0 0 0 0 255 255 255 255 255 255 255 255 255 255 255 255 255 255 255 255 255 255 255 255 0 0 0 0 255
255 0 0 0 0 0 0 0 0 0 0 0 0 0 0 0 0 0 0 0 0 0 0 0 0 0 0 0 0 255
255 0 0 0 0 0 0 0 0 0 0 0 0 0 0 0 0 0 0 0 0 0 0 0 0 0 0 0 0 255
255 0 0 0 0 0 0 0 0 0 0 0 0 0 0 0 0 0 0 0 0 0 0 0 0 0 0 0 0 255
255 0 0 0 0 0 0 0 0 0 0 0 0 0 0 0 0 0 0 0 0 0 0 0 0 0 0 0 0 255
255 0 0 0 0 0 0 0 0 0 0 0 0 0 0 0 0 0 0 0 0 0 0 0 0 0 0 0 0 255
255 0 0 0 0 0 0 0 0 0 0 0 0 0 0 0 0 0 0 0 0 0 0 0 0 0 0 0 0 255
255 0 0 0 0 0 0 0 0 0 0 0 0 0 0 0 0 0 0 0 0 0 0 0 0 0 0 0 0 255
255 0 0 0 0 0 0 0 0 0 0 0 0 0 0 0 0 0 0 0 0 0 0 0 0 0 0 0 0 255
255 0 0 0 0 255 255 255 255 255 255 255 255 255 255 255 255 255 255 255 255 255 255 255 255 0 0 0 0 255
255 0 0 0 0 0 0 0 0 0 0 0 0 0 0 0 0 0 0 0 0 0 0 0 0 0 0 0 0 255
255 0 0 0 0 0 0 0 0 0 0 0 0 0 0 0 0 0 0 0 0 0 0 0 0 0 0 0 0 255
255 0 0 0 0 0 0 0 0 0 0 0 0 0 0 0 0 0 0 0 0 0 0 0 0 0 0 0 0 255
255 0 0 0 0 0 0 0 0 0 0 0 0 0 0 0 0 0 0 0 0 0 0 0 0 0 0 0 0 255
255 0 0 0 0 0 0 0 0 0 0 0 0 0 0 0 0 0 0 0 0 0 0 0 0 0 0 0 0 255
255 0 0 0 0 0 0 0 0 0 0 0 0 0 0 0 0 0 0 0 0 0 0 0 0 0 0 0 0 255
255 0 0 0 0 0 0 0 0 0 0 0 0 0 0 0 0 0 0 0 0 0 0 0 0 0 0 0 0 255
255 0 0 0 0 0 0 0 0 0 0 0 0 0 0 0 0 0 0 0 0 0 0 0 0 0 0 0 0 255
255 0 0 0 0 0 0 0 0 0 0 0 0 0 0 0 0 0 0 0 0 0 0 0 0 0 0 0 0 255
255 255 255 255 255 255 255 255 255 255 255 255 255 255 255 255 255 255 255 255 255 255 255 255 255 255 255 255 255 255
30 30
BBBBBBBBBBBBBBBBBBBBBBBBBBBBBB
B~~~~~~~~~B~~~~~~~~~~~~~~~~~~B
B~~~~~~~~~B~~~~~~~~~~~~~~~~~~B
B~~~~~~~~~B~~~~~~~~~~~~~~~~~~B
B~~~~~~~~~B~~~~~~~~~~~~~~~~~~B
B~~~~~~~~~B~~~~~~~B~~~~~~~~~~B
B~~~~~~~~~B~~~~~~~B~~~~~~~~~~B
B~~~~~~~~~B~~~~~~~B~~~~~~~~~~B
B~~~~~~~~~B~~~~~~~B~~~~~~~~~~B
B~~~~~~~~~B~~~~~~~BBBBBBBBBBBB
B~~~~~~~~~B~~~~~~~~~~~~~~~~~~B
B~~~~~~~~~B~~~~~~~~~~~~~~~~~~B
B~~~~BBBBBB~~~~~~~~~~~~~~~~~~B
B~~~~~~~~~~~~~~~~~~~~~~~~~~~~B
B~~~~~~~~~~~~~~~~~~~~~~~~~~~~B
B~~~~~~~~~~~~~~~~~~~~~~~~~~~~B
B~~~~~~~~~~~~~~~~~~~~~~~~~~~~B
B~~~~~~~~~~~~~~~~~~BBBBBB~~~~B
B~~~~~~~~~~~~~~~~~~B~~~~~~~~~B
B~~~~~~~~~~~~~~~~~~B~~~~~~~~~B
BBBBBBBBBBBB~~~~~~~B~~~~~~~~~B
B~~~~~~~~~~B~~~~~~~B~~~~~~~~~B
B~~~~~~~~~~B~~~~~~~B~~~~~~~~~B
B~~~~~~~~~~B~~~~~~~B~~~~~~~~~B
B~~~~~~~~~~B~~~~~~~B~~~~~~~~~B
B~~~~~~~~~~~~~~~~~~B~~~~~~~~~B
B~~~~~~~~~~~~~~~~~~B~~~~~~~~~B
B~~~~~~~~~~~~~~~~~~B~~~~~~~~~B
B~~~~~~~~~~~~~~~~~~B~~~~~~~~~B
BBBBBBBBBBBBBBBBBBBBBBBBBBBBBB
255 255 255 255 255 255 255 255 255 255 255 255 255 255 255 255 255 255 255 255 255 255 255 255 255 255 255 255 255 255
255 0 0 0 0 0 0 0 0 0 255 0 0 0 0 0 0 0 0 0 0 0 0 0 0 0 0 0 0 255
255 0 0 0 0 0 0 0 0 0 255 0 0 0 0 0 0 0 0 0 0 0 0 0 0 0 0 0 0 255
255 0 0 0 0 0 0 0 0 0 255 0 0 0 0 0 0 0 0 0 0 0 0 0	0 0 0 0 0 255
255 0 0 0 0 0 0 0 0 0 255 0 0 0 0 0 0 0 0 0 0 0 0 0 0 0 0 0 0 255
255 0 0 0 0 0 0 0 0 0 255 0 0 0 0 0 0 0 255 0 0 0 0 0 0 0 0 0 0 255
255 0 0 0 0 0 0 0 0 0 255 0 0 0 0 0 0 0 255 0 0 0 0 0 0 0 0 0 0 255
255 0 0 0 0 0 0 0 0 0 255 0 0 0 0 0 0 0 255 0 0 0 0 0 0 0 0 0 0 255
255 0 0 0 0 0 0 0 0 0 255 0 0 0 0 0 0 0 255 0 0 0 0 0 0 0 0 0 0 255
255 0 0 0 0 0 0 0 0 0 255 0 0 0 0 0 0 0 255 255 255 255 255 255 255 255 255 255 255 255
255 0 0 0 0 0 0 0 0 0 255 0 0 0 0 0 0 0 0 0 0 0 0 0 0 0 0 0 0 255
255 0 0 0 0 0 0 0 0 0 255 0 0 0 0 0 0 0 0 0 0 0 0 0 0 0 0 0 0 255
255 0 0 0 0 255 255 255 255 255	255 0 0 0 0 0 0 0 0 0 0 0 0 0 0 0 0 0 0 255
255 0 0 0 0 0 0 0 0 0 0 0 0 0 0 0 0 0 0 0 0 0 0 0 0 0 0 0 0 255
255 0 0 0 0 0 0 0 0 0 0 0 0 0 0 0 0 0 0 0 0 0 0 0 0 0 0 0 0 255
255 0 0 0 0 0 0 0 0 0 0 0 0 0 0 0 0 0 0 0 0 0 0 0 0 0 0 0 0 255
255 0 0 0 0 0 0 0 0 0 0 0 0 0 0 0 0 0 0 0 0 0 0 0 0 0 0 0 0 255
255 0 0 0 0 0 0 0 0 0 0 0 0 0 0 0 0 0 0 255 255 255 255 255 255 0 0 0 0 255
255 0 0 0 0 0 0 0 0 0 0 0 0 0 0 0 0 0 0 255 0 0 0 0 0 0 0 0 0 255
255 0 0 0 0 0 0 0 0 0 0 0 0 0 0 0 0 0 0 255 0 0 0 0 0 0 0 0 0 255
255 255 255 255 255 255 255 255 255 255 255 255 0 0 0 0 0 0 0 255 0 0 0 0 0 0 0 0 0 255
255 0 0 0 0 0 0 0 0 0 0 255 0 0 0 0 0 0 0 255 0 0 0 0 0 0 0 0 0 255
255 0 0 0 0 0 0 0 0 0 0 255 0 0 0 0 0 0 0 255 0 0 0 0 0 0 0 0 0 255
255 0 0 0 0 0 0 0 0 0 0 255 0 0 0 0 0 0 0 255 0 0 0 0 0 0 0 0 0 255
255 0 0 0 0 0 0 0 0 0 0 255 0 0 0 0 0 0 0 255 0 0 0 0 0 0 0 0 0 255
255 0 0 0 0 0 0 0 0 0 0 0 0 0 0 0 0 0 0 255 0 0 0 0 0 0 0 0 0 255
255 0 0 0 0 0 0 0 0 0 0 0 0 0 0 0 0 0 0 255 0 0 0 0 0 0 0 0 0 255
255 0 0 0 0 0 0 0 0 0 0 0 0 0 0 0 0 0 0 255 0 0 0 0 0 0 0 0 0 255
255 0 0 0 0 0 0 0 0 0 0 0 0 0 0 0 0 0 0 255 0 0 0 0 0 0 0 0 0 255
255 255 255 255 255 255 255 255 255 255 255 255 255 255 255 255 255 255 255 255 255 255 255 255 255 255 255 255 255 255
30 30
BBBBBBBBBBBBBBBBBBBBBBBBBBBBBB
B~~~~~~~~~~~~~~~~~~~~~~~~~~~~B
B~~~~~~~~~~~~~~~~~~~~~~~~~~~~B
B~~~~~~~~~~~~~~~~~~~~~~~~~~~~B
B~~~~BBBBBBB~~~~~~BBBBBBB~~~~B
B~~~~B~~~~~~~~~~~~~~~~~~B~~~~B
B~~~~B~~~~~~~~~~~~~~~~~~B~~~~B
B~~~~B~~~~~~~~~~~~~~~~~~B~~~~B
B~~~~~~~~~~~B~~~~~B~~~~~~~~~~B
B~~~~~~~~~~~B~~~~~B~~~~~~~~~~B
B~~~~~~~~~~~B~~~~~B~~~~~~~~~~B
B~~~~~~~~~~~B~~~~~B~~~~~~~~~~B
B~~~~BBBBBBBB~~~~~BBBBBBB~~~~B
B~~~~~~~~~~~~~~~~~~~~~~~~~~~~B
B~~~~~~~~~~~~~~~~~~~~~~~~~~~~B
B~~~~~~~~~~~~~~~~~~~~~~~~~~~~B
B~~~~BBBBBBBB~~~~~BBBBBBB~~~~B
B~~~~~~~~~~~B~~~~~B~~~~~~~~~~B
B~~~~~~~~~~~B~~~~~B~~~~~~~~~~B
B~~~~~~~~~~~B~~~~~B~~~~~~~~~~B
B~~~~~~~~~~~B~~~~~B~~~~~~~~~~B
B~~~~B~~~~~~~~~~~~~~~~~~B~~~~B
B~~~~B~~~~~~~~~~~~~~~~~~B~~~~B
B~~~~B~~~~~~~~~~~~~~~~~~B~~~~B
B~~~~B~~~~~~~~~~~~~~~~~~B~~~~B
B~~~~BBBBBBB~~~~~~BBBBBBB~~~~B
B~~~~~~~~~~~~~~~~~~~~~~~~~~~~B
B~~~~~~~~~~~~~~~~~~~~~~~~~~~~B
B~~~~~~~~~~~~~~~~~~~~~~~~~~~~B
BBBBBBBBBBBBBBBBBBBBBBBBBBBBBB
255 255 255 255 255 255 255 255 255 255 255 255 255 255 255 255 255 255 255 255 255 255 255 255 255 255 255 255 255 255
255 0 0 0 0 0 0 0 0 0 0 0 0 0 0 0 0 0 0 0 0 0 0 0 0 0 0 0 0 255
255 0 0 0 0 0 0 0 0 0 0 0 0 0 0 0 0 0 0 0 0 0 0 0 0 0 0 0 0 255
255 0 0 0 0 0 0 0 0 0 0 0 0 0 0 0 0 0 0 0 0 0 0 0 0 0 0 0 0 255
255 0 0 0 0 255 255 255 255 255 255 255 0 0 0 0 0 0 255 255 255 255 255 255 255 0 0 0 0 255
255 0 0 0 0 255 0 0 0 0 0 0 0 0 0 0 0 0 0 0 0 0 0 0 255 0 0 0 0 255
255 0 0 0 0 255 0 0 0 0 0 0 0 0 0 0 0 0 0 0 0 0 0 0 255 0 0 0 0 255
255 0 0 0 0 255 0 0 0 0 0 0 0 0 0 0 0 0 0 0 0 0 0 0 255 0 0 0 0 255
255 0 0 0 0 0 0 0 0 0 0 0 255 0 0 0 0 0 255 0 0 0 0 0 0 0 0 0 0 255
255 0 0 0 0 0 0 0 0 0 0 0 255 0 0 0 0 0 255 0 0 0 0 0 0 0 0 0 0 255
255 0 0 0 0 0 0 0 0 0 0 0 255 0 0 0 0 0 255 0 0 0 0 0 0 0 0 0 0 255
255 0 0 0 0 0 0 0 0 0 0 0 255 0 0 0 0 0 255 0 0 0 0 0 0 0 0 0 0 255
255 0 0 0 0 255 255 255 255 255 255 255 255 0 0 0 0 0 255 255 255 255 255 255 255 0 0 0 0 255
255 0 0 0 0 0 0 0 0 0 0 0 0 0 0 0 0 0 0 0 0 0 0 0 0 0 0 0 0 255
255 0 0 0 0 0 0 0 0 0 0 0 0 0 0 0 0 0 0 0 0 0 0 0 0 0 0 0 0 255
255 0 0 0 0 0 0 0 0 0 0 0 0 0 0 0 0 0 0 0 0 0 0 0 0 0 0 0 0 255
255 0 0 0 0 255 255 255 255 255 255 255 255 0 0 0 0 0 255 255 255 255 255 255 255 0 0 0 0 255
255 0 0 0 0 0 0 0 0 0 0 0 255 0 0 0 0 0 255 0 0 0 0 0 0 0 0 0 0 255
255 0 0 0 0 0 0 0 0 0 0 0 255 0 0 0 0 0 255 0 0 0 0 0 0 0 0 0 0 255
255 0 0 0 0 0 0 0 0 0 0 0 255 0 0 0 0 0 255 0 0 0 0 0 0 0 0 0 0 255
255 0 0 0 0 0 0 0 0 0 0 0 255 0 0 0 0 0 255 0 0 0 0 0 0 0 0 0 0 255
255 0 0 0 0 255 0 0 0 0 0 0 0 0 0 0 0 0 0 0 0 0 0 0 255 0 0 0 0 255
255 0 0 0 0 255 0 0 0 0 0 0 0 0 0 0 0 0 0 0 0 0 0 0 255 0 0 0 0 255
255 0 0 0 0 255 0 0 0 0 0 0 0 0 0 0 0 0 0 0 0 0 0 0 255 0 0 0 0 255
255 0 0 0 0 255 0 0 0 0 0 0 0 0 0 0 0 0 0 0 0 0 0 0 255 0 0 0 0 255
255 0 0 0 0 255 255 255 255 255 255 255 0 0 0 0 0 0 255 255 255 255 255 255 255 0 0 0 0 255
255 0 0 0 0 0 0 0 0 0 0 0 0 0 0 0 0 0 0 0 0 0 0 0 0 0 0 0 0 255
255 0 0 0 0 0 0 0 0 0 0 0 0 0 0 0 0 0 0 0 0 0 0 0 0 0 0 0 0 255
255 0 0 0 0 0 0 0 0 0 0 0 0 0 0 0 0 0 0 0 0 0 0 0 0 0 0 0 0 255
255 255 255 255 255 255 255 255 255 255 255 255 255 255 255 255 255 255 255 255 255 255 255 255 255 255 255 255 255 255